1,2,3,4,5,6,7,8,9
7,8,9,1,2,3,4,5,6
4,5,6,7,8,9,1,2,3
5,1,2,6,4,7,9,3,8
9,3,4,8,1,5,2,6,7
8,6,7,9,3,2,5,1,4
2,4,8,3,7,1,6,9,5
3,9,5,2,6,4,8,7,1
6,7,1,5,9,8,3,4,2
